111111111111111111
1P0000000000000001
10111100111C000001
1010C0001001000001
10100000100101C101
1011110011100C1C01
1010C000100101C101
101000001001000001
10100000111C00C001
1000000000000000E1
111111111111111111
