11111111111
100P100C1C1
1C100010CE1
11111111111
